###########
##       ##
#         #
#   ###  ##
#   ###  ##
#   #    ##
#   #######
#   ##  V #
#      G  #
###########
